120
80
000000000000000000000000000000000000000000000000000000000000000111100000000000000000000000000000000000000000000000000000
000000000000000000000000000000000000000000000000000000000000000111111000000000000000000000000000000000000000000000000000
000000000000000000000000000000000000000000000000000000000000000111111111000000000000000000000000000000000000000000000000
000000000000000000000000000000000000000000000000000000000000000111111111100000000000000000000000000000000000000000000000
000000000000000000000000000000000000000000000000000000000000000111111111100000000000000000000000000000000000000000000000
000000000000000000000000000000000000000000000000000000000000000011111111110000000000000000000000000000000000000000000000
000000000000000000000000000000000000000000000000000000000000000001111111110000000000000000000000000000000000000000000000
000000000000000000000000000000000000000000000000000000000000000000011111100000000000000000000000000000000000000000000000
000000000000000000000000000000000000000000000000000000000000000000000000000000000000000000000000000000000000000000000000
000000000000000000000000000000000000000000000000000000000000000000000000000000000000000000000000000000000000000000000000
000000000000000000000000000000000000000000000000000000000000000000000000000000000000000000000000000000000000000000000000
000000000000000000000000000000000000000000000000000000000000000000000000000000000000000000000000000000000000000000000000
000000000000000000000000000000000000000000000000000000000000000000000000000000000000000000000000000000000000000000000000
000000000000000000000000000000000000000000000000000000000000000000000000000000000000000000000000000000000000000000000000
000000000000000000000000000000000000000000000000000000000000000000000000000000000000000000000000000000000000000000000000
000000000000000000000000000000000000000000000000000000000000000000000000000000000000000000000000000000000000000000000000
000000000000000000000000000000000000000000000000000000000000000000000000000000000000000000000000000000000000000000000000
000000000000000000000000000000000000000000000000000000000000000000000000000000000000000000000000000000000000000000000000
000000000000000000000000000000000000000000000000000000000000000000000000000000000000000000000000000000000000000000000000
000000000000000000000000000000000000000000000000000000000000000000000000000000000000000000000000000000000000000000000000
000000000000000000000000000000000000000000000000000000000000000000000000000000000000000000000000000000000000000000000000
000000000000000000000000000000000000000000000000000000000000000000000000000000000000000000000000000000000000000000000000
000000000000000000000000000000000000000000000000000000000000000000000000000000000000000000000000000000000000000000000000
000000000000000000000000000000000000000000000000000000000000000000000000000000000000000000000000000000000000000000000000
000000000000000000000000000000000000000000000000000000000000000000000000000000000000000000000000000000000000000000000000
000000000000000000000000000000000000000000000000000000000000000000000000000000000000000000000000000000000000000000000000
000000000000000000000000000000000000000000000000000000000000000000000000000000000000000000000000000000000000000000000000
000000000000000000000000000000000000000000000000000000000000000000000000000000000000000000000000000000000000000000000000
000000000000000000000000000000000000000000000000000000000000000000000000000000000000000000000000000000000000000000000000
000000000000000000000000000000000000000000000000000000000000000000000000000000000000000000000000000000000000000000000000
000000000000000000000000000000000000000000000000000000000000000000000000000000000000000000000000000000000000000000000000
000000000000000000000000000000000000000000000000000000000000000000000000000000000000000000000000000000000000000000000000
000000000000000000000000000000000000000000000000000000000000000000000000000000000000000000000000000000000000000000000000
000000000000000000000000000000000000000000000000000000000000000000000000000000000000000000000000000000000000000000000000
000000000000000000000000000000000000000000000000000000000000000000000000000000000000000000000000000000000000000000000000
000000000000000000000000000000000000000000000000000000000111111111000000000000000000000000000000000000000000000000000000
000000000000000000000000000000000000000000000000000000011111111111100000000000000000000000000000000000000000000000000000
000000000000000000000000000000000000000000000000000000011111111111110000000000000000000000000000000000000000000000000000
000000000000000000000000000000000000000000000000000000011111111111110000000000000000000000000000000000000000000000000000
000000000000000000000000000000000000000000000000000000011111111111100000000000000000000000000000000000000000000000000000
000000000000000000000000000000000000000000000000000000001111111111100000000000000000000000000000000000000000000000000000
000000000000000000000000000000000000000000000000000000001111111111000000000000000000000000000000000000000000000000000000
000000000000000000000000000000000000000000000000000000000111111111100000000000000000000000000000000000000000000000000000
000000000000000000000000000000000000000000000000000000000011111111110000000000000000000000000000000000000000000000000000
000000000000000000000000000000000000000000000000000000000011111111110000000000000000000000000000000000000000000000000000
000000000000000000000000000000000000000000000000000000000001111111111100000000000000000000000000000000000000000000000000
000000000000000000000000000000000000000000000000000000000000111111111111110000000000000000000000000000000000000000000000
000000000000000000000000000000000000000000000000000000000000011111111111111000000000000000000000000000000000000000000000
000000000000000000000000000000000000000000000000000000000000001111111111111100000000000000000000000000000000000000000000
000000000000000000000000000000000000000000000000000000000000000111111111111110000000000000000000000000000000000000000000
000000000000000000000000000000000000000000000000000000000000000011111111111111000000000000000000000000000000000000000000
000000000000000000000000000000000000000000000000000000000000000000111111111111000000000000000000000000000000000000000000
000000000000000000000000000000000000000000000000000000000000000000011111111111100000000000000000000000000000000000000000
000000000000000000000000000000000000000000000000000000000000000000001111111111100000000000000000000000000000000000000000
000000000000000000000000000000000000000000011100000000000000000000001111111111100000000000000000000000000000000000000000
000000000000000000000000000000000000000000011110000000000000000000001111111111100000000000000000000000000000000000000000
000000000000000000000000000000000000000000011111000000000000000000001111111111100000000000000000000000000000000000000000
000000000000000000000000000000000000000000111111100000000000000000001111111111000000000000000000000000000000000000000000
000000000000000000000000000000000000000000111111100000000000000000001111111111000000000000000000000000000000000000000000
000000000000000000000000000000000000000000111111110000000000000000001111111110000000000000000000000000000000000000000000
000000000000000000000000000000000000000000011111110000000000000000001111111110000000000000000000000000000000000000000000
000000000000000000000000000000000000000000011111111000000000000000001111111110000000000000000000000000000000000000000000
000000000000000000000000000000000000000000011111111000000000000000001111111100000000000000000000000000000000000000000000
000000000000000000000000000000000000000000011111111100000000000000001111111100000000000000000000000000000000000000000000
000000000000000000000000000000000000000000011111111111110000000000001111111000000000000000000000000000000000000000000000
000000000000000000000000000000000000000000001111111111111111111111101111110000000000000000000000000000000000000000000000
000000000000000000000000000000000000000000001111111111111111111111111111100000000000000000000000000000000000000000000000
000000000000000000000000000000000000000000000111111111111111111111111111100000000000000000000000000000000000000000000000
000000000000000000000000000000000000000000000111111111111111111111111111000000000000000000000000000000000000000000000000
000000000000000000000000000000000000000000000011111111111111111111111110000000000000000000000000000000000000000000000000
000000000000000000000000000000000000000000000001111111111111111111111100000000000000000000000000000000000000000000000000
000000000000000000000000000000000000000000000001111111111111111111111100000000000000000000000000000000000000000000000000
000000000000000000000000000000000000000000000000111111111111111111111100000000000000000000000000000000000000000000000000
000000000000000000000000000000000000000000000000111111111111111111111000000000000000000000000000000000000000000000000000
000000000000000000000000000000000000000000000000011111111111111111100000000000000000000000000000000000000000000000000000
000000000000000000000000000000000000000000000000001111111111111111000000000000000000000000000000000000000000000000000000
000000000000000000000000000000000000000000000000000111111111111110000000000000000000000000000000000000000000000000000000
000000000000000000000000000000000000000000000000000011111111111110000000000000000000000000000000000000000000000000000000
000000000000000000000000000000000000000000000000000000111111111000000000000000000000000000000000000000000000000000000000
000000000000000000000000000000000000000000000000000000011111000000000000000000000000000000000000000000000000000000000000